05 09 01
XXXXX
XG..X
X...X
X...X
X...X
X...X
XJ..X
XM..X
XXXXX
