05 06 01
XXXXX
XG..X
X...X
XJ..X
XM..X
XXXXX
