05 05 01
XXXXX
XG..X
XJ..X
XM..X
XXXXX
