07 07 01
XXXXXXX
X..G..X
X.....X
X..J..X
X.....X
X..M..X
XXXXXXX
