07 07 02
XXXXXXX
X..GG.X
X.....X
X..JJ.X
X.....X
X..M..X
XXXXXXX
