07 07 03
XXXXXXX
X.GGG.X
X.....X
X.JJJ.X
X.....X
X..M..X
XXXXXXX
