07 07 04
XXXXXXX
XGGGG.X
X.....X
XJJJJ.X
X.....X
X..M..X
XXXXXXX
