07 07 05
XXXXXXX
XGGGGGX
X.....X
XJJJJJX
X.....X
X..M..X
XXXXXXX
