07 07 03
XXXXXXX
X...G.X
X.X.X.X
X.....X
X.J...X
X....MX
XXXXXXX
