06 07 03
XXXXXX
XGX..X
XJM..X
X.X.JX
XGJ.GX
X....X
XXXXXX
