05 07 01
XXXXX
X...X
X.G.X
X.J.X
X.M.X
X...X
XXXXX
