05 08 01
XXXXX
X...X
X.G.X
X...X
X.J.X
X...X
X.M.X
XXXXX
