07 07 03
XXXXXXX
X....GX
X.X.XXX
X.....X
X.J...X
X....MX
XXXXXXX
